7 7
3 0 0 0 3 0 0
0 3 3 0 3 3 4
4 4 1 3 3 0 3
0 0 0 3 0 0 3
4 0 3 0 2 3 0 
0 0 3 3 4 3 0
3 0 0 3 0 0 3