5 6
0 0 4 0 3 1
4 0 4 3 0 0
0 0 3 3 0 4
0 4 4 0 0 0
2 0 0 3 3 0