7 7
0 0 0 0 0 3 1
0 0 4 4 4 0 0
0 3 0 0 0 3 0
0 3 0 3 3 4 3
0 0 3 4 0 0 0
3 0 3 0 4 0 0
2 0 3 3 0 0 0